//Hard 2
@@@@@@  @@@@W@@
@@...|  |....@@
@@...@  @.@@.@@
@@..@@  @@...@@
@@@.@@  @@.@.@@
@@...|  |..@.$@
@@@@@@  @@@@@@@