//Hard 1

W...@@@ @@@@@@@
@.@.@@@ @@@@@.@
@.....| |.....@
@..@@$@ @@@@.@@
@.@@@.@ @@@@.@@
@...@.@ @@@...@
@@@...| |...@@@
